########
#      #
# *\   #
# R *  #
L .#*. #
########