########
# *  * #
#    * #
#.R#   #
L \    #
########