######
#   *#
#\#  #
#.R**#
L* *.#
######